111111111111111111111111111111111
100000000001000001000000000000001
110110101111010101111110111111101
100010101000010101000100000001001
101010001011110001010101011111001
101010100010000100010001010001101
100011110110111110111111010100101
101000000010100000000001010110101
101111111000101011110101000100101
101000101010001000100001011101101
101010001111101010101101000000001
100010100010001010101000001011101
101110101010111110101111101000111
100010001010100000001000001010001
110110101110111011111110111111101
100000100000000010000000001000001
111111111111111111111111111111111
