111111111111111111111111111111111
100001001000000000000100000100001
111101101111101110110101010111101
100001000000000000010101010000001
101100010110110111110000010110111
100111010000010101010111110000001
110000011111010001010100000111101
100101000000011101000111011101001
111101110111001000010000000001011
100101000000011011111111101100001
110101011111001000010101000101111
100101010000011111000101010100001
110001010101000001010100010111101
100100010101110100010001010000001
101111000100010110111101111101111
100001010101000010100000000100001
111111111111111111111111111111111
