111111111111111111111111111111111
100000000000000000000000000000001
100010000000000000000000000000001
100010000000000000000000000000001
100010000000000100000000000000001
100010000000000100000000000000001
100010010000100100000000000000001
100010010000100100000000000000001
100010010000000100000000000000001
100010010001110100000000000000001
100010000000000100000000000000001
100011111111111100000000000000001
100000000000000100000000000000001
100000000000000000000000000000001
100000000000000000000000000000001
100000000000000000000000000000001
111111111111111111111111111111111
