111111111111111111111111111111111
100111111100000110000100011011101
111110011110101111111111101000101
111011111010111010000110000000101
101111010010000000110011111110101
101010000100111111000001111000101
101111111001000000000001100000101
100011111111111111111000001000101
100001000000000111111111111111111
100001111010110110100011111001101
100000001110110110101101001001101
110011100000000001111000001111001
110110001111110110110000110001001
100100101000111111101110001010001
100111111110000111111111111110001
100000000000110000000000001000001
111111111111111111111111111111111
