111111111111111111111111111111111
100000000000000000000000000000001
100001000011111000000000000000001
100001000010001100000000000000001
100001111110000110000000000000001
100001000000000011111111100000001
100001100000000000000000100000001
100000100100000010000000110000001
100000110000000000000000010000001
100000010000110100000000001000001
100000010000000000000000000100001
100001110000000000000000000100001
100001110000000000000000000100001
100000000000000000000000000000001
100000000000000000000000000000001
100000000000000000000000000000001
111111111111111111111111111111111
