111111111111111111111111111111111
111001001110010010001110000100111
110000100100100000100100000000011
100110010001001101010001110110001
100001010001010000001010000001001
110101001010010100101000111100101
110100100000100100100100100010011
100010101010101001010100101001001
101010010001001001010010101001001
101001010101010010001010100010011
100101000100010010001000101100111
100100101010100101010100100010111
100010101010100100000100101010011
100010010001001001010010101001001
110001000100000010001000000100011
111000001110001010101010100010111
111111111111111111111111111111111
